█████████
█S    █ █
█ ███ █ █
█ █ █   █
███ ███ █
█   █   █
█ ███ ███
█      G█
█████████
