█████████████████████████████████████████████████████████████
█S        █   █     █         █     █       █     █       █ █
█ ███████ █ █ █ █ ███ █████ █ █████ █ ███ █ ███ █ ███ █ █ █ █
█ █     █ █ █ █ █       █   █     █     █ █     █   █ █ █ █ █
█████ ███ █ █ ███ ███████ ███████ █ █████ █████████ ███ █ █ █
█     █   █ █   █   █   █   █     █ █     █       █   █ █   █
█ ███ █ ███ ███ █████ █ ███ █ █████ █ █████ █ ███████ █ █████
█ █   █   █ █ █   █   █     █ █     █   █   █   █   █ █     █
█ ███████ █ █ ███ █ █████████ █████████ ███ ███ █ █ █ █ ███ █
█       █ █ █     █         █     █   █   █   █   █   █   █ █
█ ███ ███ █ █ █████ ███████ █████ █ █ ███ ███ █████████████ █
█ █ █   █ █ █   █         █   █ █   █ █   █ █ █             █
█ █ ███ █ █ ███ █████████████ █ █████ █ ███ █ █ █████ █████ █
█ █   █ █   █   █       █     █   █ █   █     █ █   █   █   █
█ ███ █ █████ ███ █████ █ █████ █ █ █████ ███████ █ ███ █ ███
█ █   █     █ █   █     █   █   █ █ █     █       █ █   █   █
█ █ █ ███ ███ █ ███ ███████ █ █ █ █ █ █████████ ███ █ █████ █
█   █   █   █ █ █ █     █   █ █ █   █       █   █   █   █ █ █
███████ ███ █ █ █ █████ █ ███ █ ███████████ █ ███ █████ █ █ █
█         █     █         █   █               █         █  G█
█████████████████████████████████████████████████████████████
